species	behavior
AAUR	soc
APUR	solloss
AVIR	solanc
HLIG	soc
HQUA	solloss
HRUB	poly
LALB	poly
LCAL	poly
LFIG	solloss
LLEU	solloss
LMAL	soc
LMAR	soc
LOEN	solloss
LPAU	soc
LVIE	solloss
LZEP	soc
NMEL	solanc
MGEN	poly
DNOV	solanc
