species	behavior
AAUR	soc
APUR	sol
AVIR	sol
HLIG	soc
HQUA	sol
HRUB	soc
LALB	soc
LCAL	soc
LFIG	sol
LLEU	sol
LMAL	soc
LMAR	soc
LOEN	sol
LPAU	soc
LVIE	sol
LZEP	soc
NMEL	sol
MGEN	soc
DNOV	sol
